#####################
#                   #
# ###               #
#                   #
#            @      #
#        ######     #
#                   #
#####################