000000000000000000000000000000000000000000000000000B
000000000000000000000000000000000000000000000000000B
000000000000000000000000000000000000000000000000000B
0000000000000000000000BBBBB*B0000000000000000000000B
000000000000*00000000000000000000000000000000000000B
0000000000000000*0000000000000BBB000000000000000000E
000000000P000000000000000000BB00000S0000GGGGGGGGGGGG
GGGGGGGGGGGGGGGGGG0000000000000000GGGGGGDDD0000DDGGB
0DDDDDDDDDDDDDDDD000000000m000000000000000000GGGDDD0
00DDDDDDDDDDDDDD00*0000s000000000000000GGGGGGDDDDD00
0000DDDDDDDDD0000000000000000000000GGGGDDDDDDDDDD000
000000000000000000000000000000000GGDDDDDDDDDD0000000
0000000000000000000000GGGGGG000000000000000000000000