0000000000000000000000000000000000000000000000000000
0000000000000000000000000000000000000000000000000000
0000000000000000000000000000000000000000000000000000
0000000000000000000000BBBBBBB00000000000000000000000
0000000000000000000000000000000000000000000000000000
00000000000000000000000000000000000000000000E0000000
000000000P000000000000000000000000000000GGGGGGGGG000
GGGGGGGGGGGGGGGGGG0000000000000GGGGGGGGGDDD0000DDGGG
0DDDDDDDDDDDDDDDD0000000000000000000000000000GGGDDD0
00DDDDDDDDDDDDDD00000000000000000000000GGGGGGDDDDD00
0000DDDDDDDDD0000000000000000000000GGGGDDDDDDD000000
000000000000000000000000000000000GGDDDDDDDDDD0000000
0000000000000000000000GGGGGG000000000000000000000000