BBBBBBBBBBBBBBBBBBBBBBBBBBBBBBBBBBBBBBBBBBBBBBBBBBBBBBBBBBBBBBBBBBBBBBBBBBBBBBBBBBBBBBBBBBBBBBBBB
B00000000000000000000000000000000000000000000000000000000000000000000000000000000000000000000000B
B00000000*00000000000000000000000000000000000000000000000000000000000000000000000000000000000000B  
B000000**000000000000000000000000000000000000000000000000000000000000000000000000000000000000000B
B00000000000000000000000*00000000000000000000000000000000000000000000000000000000000000000000000B
0000P000000M0000000000000*0000000000000000000000000000000000000000000000000000000000000000000000B          
B*BBBBBBBBB00000BB0*B*0BBB000000000000000s000000000000000000000000000000000000000000000000000000B 
BBBBBBB**000000000000B00000000000000000000000000000000000000000000000000000000000000000000000000B
B00BBB000000000000000000000**0000S0000B0B0000000000000000000000000000000000000000000000000000000B
B00000000000000000000000000BBBBBBBB*BBB0BBB00000000000000000000000000000000000000000000000000000B
B000000000000000000000000000BBBBB00000B0BB000000000000000000000000000000000000000000000000000000B
B00000000000000000000000000000BB000000B0B000000000000000000000000000000000s000000000000000000000B
B0000000000000000000000000000000000000BmB00000000000000000000BB00000000000000s000000000000000000B
B0000000000000000000000000000000000000B0B00000000000000000*BBBBBB0000000000000000000000000000000B
B0000000000000000000000000000000000000000000000000000000BBBBBBBBBBBB0000000000000000000000000000B
B00000000000000000000000000000000000000000000000000000BBBBBBBBBBBBBBBB00000000000000000000000000E
B00000000000000000000000000000000000BBB0BB000BBBBB00BBBBBBBBBBBBBBBBBBBBBBBBBBBBB0BBBB0*0*0BBBBBB
B0000000000000000000000000000000000000B0B000000000000000000000000000000000000000000000000000B00BB  
B0000000000000000000000000000000000000BBB0000000000000000000000000000000000000000000000000000000B
                           